5 20 1000
####################
#   >              #
#          PB      #
# **  *            #	   
####################


